BL,BL,BL,BL,BL,BL,BL,BL,BL,BL,BL,BL,BL,BL,BL,BL,BL,BL,BL,BL,BL,BL,BL,BL,BL,BL,BL,BL,BL,BL,BL,BL,BL,BL,BL,BL,BL,BL,BL,BL,BL,BL,BL,BL,BL,BL,BL
BL,BL,BL,BL,BL,BL,BL,BL,BL,BL,BL,BL,BL,BL,BL,BL,BL,BL,BL,BL,BL,BL,BL,BL,BL,BL,BL,BL,BL,BL,BL,BL,BL,BL,BL,BL,BL,BL,BL,BL,BL,BL,BL,BL,BL,BL,BL
BL,BL,BL,BL,BL,BL,BL,BL,BL,BL,BL,BL,BL,BL,BL,BL,BL,BL,BL,BL,BL,BL,BL,BL,BL,BL,BL,BL,BL,BL,BL,BL,BL,BL,BL,BL,BL,BL,BL,BL,BL,BL,BL,BL,BL,BL,BL
BL,BL,BL,BL,BL,BL,BL,BL,BL,BL,BL,BL,BL,BL,BL,BL,BL,BL,BL,BL,BL,BL,BL,BL,BL,BL,BL,BL,BL,BL,BL,BL,BL,BL,BL,BL,BL,BL,BL,BL,BL,BL,BL,BL,BL,BL,BL
BL,BL,BL,BL,BL,BL,BL,BL,BL,BL,BL,BL,BL,BL,BL,BL,BL,BL,BL,BL,BL,BL,BL,BL,BL,BL,BL,BL,BL,BL,BL,BL,BL,BL,BL,BL,BL,BL,BL,BL,BL,BL,BL,BL,BL,BL,BL
BL,BL,BL,BL,BL,W0,EN,EN,EN,EN,EN,EN,EN,EN,EN,EN,EN,EN,EN,EN,EN,EN,EN,EN,EN,EN,EN,EN,EN,EN,EN,EN,EN,EN,EN,EN,EN,EN,EN,EN,EN,W4,BL,BL,BL,BL,BL
BL,BL,BL,BL,BL,EW,BL,BL,BL,BL,BL,BL,BL,BL,BL,BL,BL,BL,BL,BL,BL,BL,BL,BL,BL,BL,BL,BL,BL,BL,BL,BL,BL,BL,BL,BL,BL,BL,BL,BL,BL,EE,BL,BL,BL,BL,BL
BL,BL,BL,BL,BL,EW,BL,BL,BL,BL,BL,BL,BL,BL,BL,BL,BL,BL,BL,BL,BL,BL,BL,BL,BL,BL,BL,BL,BL,BL,BL,BL,BL,BL,BL,BL,BL,BL,BL,BL,BL,EE,BL,BL,BL,BL,BL
BL,BL,BL,BL,BL,EW,BL,BL,BL,BL,BL,BL,BL,BL,BL,BL,BL,BL,BL,BL,BL,BL,BL,BL,BL,BL,BL,BL,BL,BL,BL,BL,BL,BL,BL,BL,BL,BL,BL,BL,BL,EE,BL,BL,BL,BL,BL
BL,BL,BL,BL,BL,EW,BL,BL,BL,BL,BL,BL,BL,BL,BL,BL,BL,BL,BL,BL,BL,BL,BL,BL,BL,BL,BL,BL,BL,BL,BL,BL,BL,BL,BL,BL,BL,BL,BL,BL,BL,EE,BL,BL,BL,BL,BL
BL,BL,BL,BL,BL,EW,BL,BL,BL,BL,BL,BL,BL,BL,BL,BL,BL,BL,BL,BL,BL,BL,BL,BL,BL,BL,BL,BL,BL,BL,BL,BL,BL,BL,BL,BL,BL,BL,BL,BL,BL,EE,BL,BL,BL,BL,BL
BL,BL,BL,BL,BL,EW,BL,BL,BL,BL,BL,BL,BL,BL,BL,BL,BL,BL,BL,BL,BL,BL,BL,BL,BL,BL,BL,BL,BL,BL,BL,BL,BL,BL,BL,BL,BL,BL,BL,BL,BL,EE,BL,BL,BL,BL,BL
BL,BL,BL,BL,BL,EW,BL,BL,BL,BL,BL,BL,BL,BL,BL,BL,BL,BL,BL,BL,BL,BL,BL,BL,BL,BL,BL,BL,BL,BL,BL,BL,BL,BL,BL,BL,BL,BL,BL,BL,BL,EE,BL,BL,BL,BL,BL
BL,BL,BL,BL,BL,EW,BL,BL,BL,BL,BL,BL,BL,BL,BL,BL,BL,BL,BL,BL,BL,BL,BL,BL,BL,BL,BL,BL,BL,BL,BL,BL,BL,BL,BL,BL,BL,BL,BL,BL,BL,EE,BL,BL,BL,BL,BL
BL,BL,BL,BL,BL,EW,BL,BL,BL,BL,BL,BL,BL,BL,BL,BL,BL,BL,BL,BL,BL,BL,BL,BL,BL,BL,BL,BL,BL,BL,BL,BL,BL,BL,BL,BL,BL,BL,BL,BL,BL,EE,BL,BL,BL,BL,BL
BL,BL,BL,BL,BL,EW,BL,BL,BL,BL,BL,BL,BL,BL,BL,BL,BL,BL,BL,BL,BL,BL,BL,BL,BL,BL,BL,BL,BL,BL,BL,BL,BL,BL,BL,BL,BL,BL,BL,BL,BL,EE,BL,BL,BL,BL,BL
BL,BL,BL,BL,BL,EW,BL,BL,BL,BL,BL,BL,BL,BL,BL,BL,BL,BL,BL,BL,BL,BL,BL,BL,BL,BL,BL,BL,BL,BL,BL,BL,BL,BL,BL,BL,BL,BL,BL,BL,BL,EE,BL,BL,BL,BL,BL
BL,BL,BL,BL,BL,EW,BL,BL,BL,BL,BL,BL,BL,BL,BL,BL,BL,BL,BL,BL,BL,BL,BL,BL,BL,BL,BL,BL,BL,BL,BL,BL,BL,BL,BL,BL,BL,BL,BL,BL,BL,EE,BL,BL,BL,BL,BL
BL,BL,BL,BL,BL,EW,BL,BL,BL,BL,BL,BL,BL,BL,BL,BL,BL,BL,BL,BL,BL,BL,BL,BL,BL,BL,BL,BL,BL,BL,BL,BL,BL,BL,BL,BL,BL,BL,BL,BL,BL,EE,BL,BL,BL,BL,BL
BL,BL,BL,BL,BL,EW,BL,BL,BL,BL,BL,BL,BL,BL,BL,BL,BL,BL,BL,BL,BL,BL,BL,BL,BL,BL,BL,BL,BL,BL,BL,BL,BL,BL,BL,BL,BL,BL,BL,BL,BL,EE,BL,BL,BL,BL,BL
BL,BL,BL,BL,BL,EW,BL,BL,BL,BL,BL,BL,BL,BL,BL,BL,BL,BL,BL,BL,BL,BL,BL,BL,BL,BL,BL,BL,BL,BL,BL,BL,BL,BL,BL,BL,BL,BL,BL,BL,BL,EE,BL,BL,BL,BL,BL
BL,BL,BL,BL,BL,EW,BL,BL,BL,BL,BL,BL,BL,BL,BL,BL,BL,BL,BL,BL,BL,BL,BL,BL,BL,BL,BL,BL,BL,BL,BL,BL,BL,BL,BL,BL,BL,BL,BL,BL,BL,EE,BL,BL,BL,BL,BL
BL,BL,BL,BL,BL,EW,BL,BL,BL,BL,BL,BL,BL,BL,BL,BL,BL,BL,BL,BL,BL,BL,BL,BL,BL,BL,BL,BL,BL,BL,BL,BL,BL,BL,BL,BL,BL,BL,BL,BL,BL,EE,BL,BL,BL,BL,BL
BL,BL,BL,BL,BL,EW,BL,BL,BL,BL,BL,BL,BL,BL,BL,BL,BL,BL,BL,BL,BL,BL,BL,BL,BL,BL,BL,BL,BL,BL,BL,BL,BL,BL,BL,BL,BL,BL,BL,BL,BL,EE,BL,BL,BL,BL,BL
BL,BL,BL,BL,BL,EW,BL,BL,BL,BL,BL,BL,BL,BL,BL,BL,BL,BL,BL,BL,BL,BL,BL,BL,BL,BL,BL,BL,BL,BL,BL,BL,BL,BL,BL,BL,BL,BL,BL,BL,BL,EE,BL,BL,BL,BL,BL
BL,BL,BL,BL,BL,EW,BL,BL,BL,BL,BL,BL,BL,BL,BL,BL,BL,BL,BL,BL,BL,BL,BL,BL,BL,BL,BL,BL,BL,BL,BL,BL,BL,BL,BL,BL,BL,BL,BL,BL,BL,EE,BL,BL,BL,BL,BL
BL,BL,BL,BL,BL,EW,BL,BL,BL,BL,BL,BL,BL,BL,BL,BL,BL,BL,BL,BL,BL,BL,BL,BL,BL,BL,BL,BL,BL,BL,BL,BL,BL,BL,BL,BL,BL,BL,BL,BL,BL,EE,BL,BL,BL,BL,BL
BL,BL,BL,BL,BL,EW,BL,BL,BL,BL,BL,BL,BL,BL,BL,BL,BL,BL,BL,BL,BL,BL,BL,BL,BL,BL,BL,BL,BL,BL,BL,BL,BL,BL,BL,BL,BL,BL,BL,BL,BL,EE,BL,BL,BL,BL,BL
BL,BL,BL,BL,BL,EW,BL,BL,BL,BL,BL,BL,BL,BL,BL,BL,BL,BL,BL,BL,BL,BL,BL,BL,BL,BL,BL,BL,BL,BL,BL,BL,BL,BL,BL,BL,BL,BL,BL,BL,BL,EE,BL,BL,BL,BL,BL
BL,BL,BL,BL,BL,EW,BL,BL,BL,BL,BL,BL,BL,BL,BL,BL,BL,BL,BL,BL,BL,BL,BL,BL,BL,BL,BL,BL,BL,BL,BL,BL,BL,BL,BL,BL,BL,BL,BL,BL,BL,EE,BL,BL,BL,BL,BL
BL,BL,BL,BL,BL,EW,BL,BL,BL,BL,BL,BL,BL,BL,BL,BL,BL,BL,BL,BL,BL,BL,BL,BL,BL,BL,BL,BL,BL,BL,BL,BL,BL,BL,BL,BL,BL,BL,BL,BL,BL,EE,BL,BL,BL,BL,BL
BL,BL,BL,BL,BL,EW,BL,BL,BL,BL,BL,BL,BL,BL,BL,BL,BL,BL,BL,BL,BL,BL,BL,BL,BL,BL,BL,BL,BL,BL,BL,BL,BL,BL,BL,BL,BL,BL,BL,BL,BL,EE,BL,BL,BL,BL,BL
BL,BL,BL,BL,BL,EW,BL,BL,BL,BL,BL,BL,BL,BL,BL,BL,BL,BL,BL,BL,BL,BL,BL,BL,BL,BL,BL,BL,BL,BL,BL,BL,BL,BL,BL,BL,BL,BL,BL,BL,BL,EE,BL,BL,BL,BL,BL
BL,BL,BL,BL,BL,EW,BL,BL,BL,BL,BL,BL,BL,BL,BL,BL,BL,BL,BL,BL,BL,BL,BL,BL,BL,BL,BL,BL,BL,BL,BL,BL,BL,BL,BL,BL,BL,BL,BL,BL,BL,EE,BL,BL,BL,BL,BL
BL,BL,BL,BL,BL,EW,BL,BL,BL,BL,BL,BL,BL,BL,BL,BL,BL,BL,BL,BL,BL,BL,BL,BL,BL,BL,BL,BL,BL,BL,BL,BL,BL,BL,BL,BL,BL,BL,BL,BL,BL,EE,BL,BL,BL,BL,BL
BL,BL,BL,BL,BL,EW,BL,BL,BL,BL,BL,BL,BL,BL,BL,BL,BL,BL,BL,BL,BL,BL,BL,BL,BL,BL,BL,BL,BL,BL,BL,BL,BL,BL,BL,BL,BL,BL,BL,BL,BL,EE,BL,BL,BL,BL,BL
BL,BL,BL,BL,BL,EW,BL,BL,BL,BL,BL,BL,BL,BL,BL,BL,BL,BL,BL,BL,BL,BL,BL,BL,BL,BL,BL,BL,BL,BL,BL,BL,BL,BL,BL,BL,BL,BL,BL,BL,BL,EE,BL,BL,BL,BL,BL
BL,BL,BL,BL,BL,WC,ES,ES,ES,ES,ES,ES,ES,ES,ES,ES,ES,ES,ES,ES,ES,ES,ES,ES,ES,ES,ES,ES,ES,ES,ES,ES,ES,ES,ES,ES,ES,ES,ES,ES,ES,WF,BL,BL,BL,BL,BL
BL,BL,BL,BL,BL,BL,BL,BL,BL,BL,BL,BL,BL,BL,BL,BL,BL,BL,BL,BL,BL,BL,BL,BL,BL,BL,BL,BL,BL,BL,BL,BL,BL,BL,BL,BL,BL,BL,BL,BL,BL,BL,BL,BL,BL,BL,BL
BL,BL,BL,BL,BL,BL,BL,BL,BL,BL,BL,BL,BL,BL,BL,BL,BL,BL,BL,BL,BL,BL,BL,BL,BL,BL,BL,BL,BL,BL,BL,BL,BL,BL,BL,BL,BL,BL,BL,BL,BL,BL,BL,BL,BL,BL,BL
BL,BL,BL,BL,BL,BL,BL,BL,BL,BL,BL,BL,BL,BL,BL,BL,BL,BL,BL,BL,BL,BL,BL,BL,BL,BL,BL,BL,BL,BL,BL,BL,BL,BL,BL,BL,BL,BL,BL,BL,BL,BL,BL,BL,BL,BL,BL
BL,BL,BL,BL,BL,BL,BL,BL,BL,BL,BL,BL,BL,BL,BL,BL,BL,BL,BL,BL,BL,BL,BL,BL,BL,BL,BL,BL,BL,BL,BL,BL,BL,BL,BL,BL,BL,BL,BL,BL,BL,BL,BL,BL,BL,BL,BL
BL,BL,BL,BL,BL,BL,BL,BL,BL,BL,BL,BL,BL,BL,BL,BL,BL,BL,BL,BL,BL,BL,BL,BL,BL,BL,BL,BL,BL,BL,BL,BL,BL,BL,BL,BL,BL,BL,BL,BL,BL,BL,BL,BL,BL,BL,BL
BL,BL,BL,BL,BL,BL,BL,BL,BL,BL,BL,BL,BL,BL,BL,BL,BL,BL,BL,BL,BL,BL,BL,BL,BL,BL,BL,BL,BL,BL,BL,BL,BL,BL,BL,BL,BL,BL,BL,BL,BL,BL,BL,BL,BL,BL,BL
BL,BL,BL,BL,BL,BL,BL,BL,BL,BL,BL,BL,BL,BL,BL,BL,BL,BL,BL,BL,BL,BL,BL,BL,BL,BL,BL,BL,BL,BL,BL,BL,BL,BL,BL,BL,BL,BL,BL,BL,BL,BL,BL,BL,BL,BL,BL
BL,BL,BL,BL,BL,BL,BL,BL,BL,BL,BL,BL,BL,BL,BL,BL,BL,BL,BL,BL,BL,BL,BL,BL,BL,BL,BL,BL,BL,BL,BL,BL,BL,BL,BL,BL,BL,BL,BL,BL,BL,BL,BL,BL,BL,BL,BL
BL,BL,BL,BL,BL,BL,BL,BL,BL,BL,BL,BL,BL,BL,BL,BL,BL,BL,BL,BL,BL,BL,BL,BL,BL,BL,BL,BL,BL,BL,BL,BL,BL,BL,BL,BL,BL,BL,BL,BL,BL,BL,BL,BL,BL,BL,BL
BL,BL,BL,BL,BL,BL,BL,BL,BL,BL,BL,BL,BL,BL,BL,BL,BL,BL,BL,BL,BL,BL,BL,BL,BL,BL,BL,BL,BL,BL,BL,BL,BL,BL,BL,BL,BL,BL,BL,BL,BL,BL,BL,BL,BL,BL,BL
BL,BL,BL,BL,BL,BL,BL,BL,BL,BL,BL,BL,BL,BL,BL,BL,BL,BL,BL,BL,BL,BL,BL,BL,BL,BL,BL,BL,BL,BL,BL,BL,BL,BL,BL,BL,BL,BL,BL,BL,BL,BL,BL,BL,BL,BL,BL
BL,BL,BL,BL,BL,BL,BL,BL,BL,BL,BL,BL,BL,BL,BL,BL,BL,BL,BL,BL,BL,BL,BL,BL,BL,BL,BL,BL,BL,BL,BL,BL,BL,BL,BL,BL,BL,BL,BL,BL,BL,BL,BL,BL,BL,BL,BL
BL,BL,BL,BL,BL,BL,BL,BL,BL,BL,BL,BL,BL,BL,BL,BL,BL,BL,BL,BL,BL,BL,BL,BL,BL,BL,BL,BL,BL,BL,BL,BL,BL,BL,BL,BL,BL,BL,BL,BL,BL,BL,BL,BL,BL,BL,BL
BL,BL,BL,BL,BL,BL,BL,BL,BL,BL,BL,BL,BL,BL,BL,BL,BL,BL,BL,BL,BL,BL,BL,BL,BL,BL,BL,BL,BL,BL,BL,BL,BL,BL,BL,BL,BL,BL,BL,BL,BL,BL,BL,BL,BL,BL,BL
BL,BL,BL,BL,BL,BL,BL,BL,BL,BL,BL,BL,BL,BL,BL,BL,BL,BL,BL,BL,BL,BL,BL,BL,BL,BL,BL,BL,BL,BL,BL,BL,BL,BL,BL,BL,BL,BL,BL,BL,BL,BL,BL,BL,BL,BL,BL